######
#...G#
#....#
#.@..#
#....#
######